%%%%%%%%%%%%%%%%%%%%%%%%%
%...P..................o%
%.......................%
%.......................%
%.......................%
%.......................%
%.......................%
%o....................G.%
%%%%%%%%%%%%%%%%%%%%%%%%%
